3
0 0 -1 2 4 2 4 -1 -1 -1
-3 3 -2 1 -4 1 -4 4 -2 4
-7 -4 -9 1 -7 3 -1 -3 -3 -5
---
3
-3 3 -4 -3 -2 -3 -2 4 -4 4
-1000 1000 -1 -1 -1 2 3 2 3 -1
5 2 2 4 5 7 8 4 5 1
---
1
0 0 1 1 1 2 2 2 2 1
---
4
0 0 -2 1 -2 -1 0 -1 0 1
2 2 0 0 2 0 2 3 0 3
3 -1 0 0 0 -2 5 -2 5 0
6 4 4 2 3 3 5 5 6 4
---
3
3 2 2 1 2 3 6 1 6 2
6 6 5 4 3 6 6 9 8 7
13 5 9 2 9 8 12 2 12 8